NO texture/herisson_trop_bg.xpm
WE texture/cobblestone.xpm


EA texture/wall_test.xpm
SO texture/cobbled_deepslate.xpm

F 75,150,50

C 0,120,200

    1111
    1N11
    1111