NO
SO
WE
EA

F
C

111111111111
100000000001
101110000001
101 10000001
101110000001
100000000001
101110000001
10111000N001
101110000001
100000000001
111111111111
