11111111111111111111111111111111111
10000000000000000000000000000000001
10000000000000000000000000000000001
10000000011110000011111111100000001
10000000000000000000000000000000001
10000000000000000000000000000000001
100000111000000000N0000000000000001
10000010000000000000000000000000001
10000010000000000000000000000000001
10000010000000000000000000000000001
10000010000000000000000000000000001
10000000000000000000000000000000001
10000000000000000000000000000000001
10000000000000000000000000000000001
10000000000000000000000000000000001
10000000000000000000000000000000001
10000000000000000000000000000000001
10000000000000000000000000000000001
10000000000000000000000000000000001
10000000000000000000000000000000001
10000000000000000000000000000000001
11111111111111111111111111111111111