NO texture/herisson_trop_bg.xpm
EA texture/wall_test.xpm
SO texture/cobbled_deepslate.xpm

WE	texture/cobblestone.xpm

F 75,150,50
C 0,120,05
     11111111111111111111111
    1000000000110000000000001
    10110000011100000000000011
    100100000000000000000000111111111
    111111111011000001110000000000001
    100000000011000001110111111111101
11110111111111011100000000001     101
1110111111111011101010010001       1
11000000110101011100000010001
11100000000N0000000000000001
11100000000000001101010010001
101000011101010111110111100111
11110111 1110101 10111101000001
11111111 1111111 1111111111111