111111111
101000001
100100N01
100000011
111111111